1111111111
0000000000
0000000000
0000000000
00000F0000
0000010000
00001P1000
0000010000
0000000000
1111111111